11111111111111111111111111111111111111111
1E000C000P000C0000000000000000000000C0011
10000C0001000C000000000000000000000000011
10000100000000000000000000000000000000011
10000C0000000C000000000000000000000000011
10000C00001111111111111100000000000000001
10000C0000000C000000000000000000000000011
10000C0000000C000000000000000000000000011
10000C00000111111111111110000000000000111
10000C00000000000000000000000000000000011
10000C00000000000000000000000000000000011
10000C00000000000000000000000000000000011
10000C00000000000000000000000000000000011
10000C00000000000000000000000000000000011
10000C00000000000000000000000000000000011
10000C00000000000000000000000000000000011
10000C00000000000000000000000000000000011
10000C00000000000000000000000000000000011
10000C00000000000000000000000000000000011
10000C00000000000000000000000000000000011
10000C00000000000000000000000000000000011
10000C00000000000000000000000000000000011
10000C00000000000000000000000000000000011
11111111111111111111111111111111111111111