1111111111111111111111
1E10000000000C000C0001
100P000000C00010000001
100000M000000010000M11
1111111111111111111111